screen name	name	type
0127Kikki	あきひろー	random
0127Syuu	岩崎柊	random
02Ykss	瀬野尚子	random
0308Penny	どぅー@たいち・8・	random
0555068668	♥عبدالرحمن بن سعود♥	random
05t6u2	Ｒｙｕｋａ	random
__0823	muahhhh ✌	random
0oICHIKAo0	筐体合体	random
1010_nekoneko	ちゃんえる	random
10Abohish	عبدالاله الهيشه	random
11ccc	いしちあ	random
1215serina	Serina.bot	random
12GR12	Reema Ibrahim	random
135HotRu	Elijah Pierre	random
140kmh	ふくくん	random
17Kn6	ほのか	random
19teukyumin	　이쿠	random
1shi24ho	しほ	random
20132007Ndoo	Ñάđά ❀	random
2013Amh	#رآسيه_مآجد	random
2014DIS	DIS 2014	conference
223Ryuya	帰宅部	random
24_dty	りおさん	random
310_oh	ｵｵｳﾃｨ	random
3budiharjo	Tricahyo Agung B	random
3_overboard	Atheer al.nahdi♦حوش	random
40colbotto	Quarantacolbotto	random
4_alnoory	nσяα ♪̠♡̷̷̷̷̷̷̷̵	random
51stDAC	51st DAC	conference
6mni_3nk_7bibi	Roody ♔	random
7Rina	Чепкунова Регина	random
7Sofiaaaa	sofi	random
8620050	Ольга Кас	random
910take	工藤タケト	random
966asawatzky	Ally Sawatzky	random
9898Diana	ХОМА	random
9965523	-	random
a1ife	アンゼルとナツーテル	random
A4Eul	રħΘ0Θɱ λι-ßελUτίʃUι	random
A7madsss555	صافي الود	random
aaaksa20001	αмιяα αℓ-qнтαηу	random
aamas2012	AAMAS 2012	conference
abedmatar	abedmatar	random
abeelsh	Abel	random
abh1000320001	abh1000320001	random
abooo_2	Dhefaf..	random
ABOOPUII1	ABOOPUII	random
AC1586	Alba Corina García A	random
acid_eaters	steph.	random
acmchi2012	ACM CHI 2012	conference
acmmm13	ACM Multimedia 2013	conference
ACMSIGCOMM	ACM SIGCOMM	conference
acns2013	ACNS2013	conference
acordeonplayer	Uriel	random
AdamGreene86	Adam Greene	random
adamidrs	Adam Idris	random
AdeIrma992811	Dedededede~	random
AdellahTorres	Adellah 	random
adevinon	nicoué dasha	random
Adi0512	Aditi Patel	random
Adinda_Mentari	Mentari♚	random
Adrian_Ahmad	Adrian Ahmad	random
AdrianHausman	Adrian Hausman	random
AdrienLeroy2	HOUSNI MKOUBOI	random
adrizaenal	Mat Deghi.	random
Ady_maulanaa	Ady maulana	random
Aey_26M	ALANOUD	random
AfiqahFrds	afi	random
afrisard	Aℓex Frisard	random
ageel1988	عقيــل الشمــري	random
Agilent	Agilent Technologies	company
agungpraatama	TAMA	random
AgusGooner_	A G U S G O O N E R	random
Agyeiice	ICE	random
AHConstantine	amy	random
ahderoie	Baby face	random
ahhnnnnso	ทดลองโดนกัด	random
ahmadmursyidin	chid	random
aiaioxox_uw	あいちゅん∞ 秋田crew	random
aialpiani	Aii☂	random
aifbrohim	prinya	random
Aiishaagood	✨I Walk Only ✨	random
AimeKlopp	Aime Taylor	random
AimuniHassan	Mun's ✿	random
AinaNatasha17	اين ناتاشا محمود	random
ainiysmn	aini	random
AiOhna	wonderwall 	random
airiiiiiiiinnn	アイリッシュ・ハーバー	random
airischaa	FLYINGDUTCM▲N ϟ	random
AishahDipsy	Echa Choo ••	random
aishe_13H	عائشه .	random
Aisyoooong	Aisyah Nurul Aini	random
AjahItto	Itto Ajah	random
akah_321ks	あかは@CC福岡M86a	random
AkashaValentine	Akasha Valentine	random
akihiko75	あーっき	random
akis2ryo	錦戸∞あきちゃんまん	random
al3nzei_madrid_	RM4EVER || ملگــي	random
Alahlawih22	نديش.	random
AlanadeFaveri	Alana	random
AlanoudOa	العنود العبيدالله	random
albaage	alfarooq.albaaj	random
albalasheras	alba lasheras	random
albanoveldera	Alba :3	random
Alcatel_Lucent	Alcatel-Lucent	company
alexandraGh14	Alexandra Vidal♥	random
Alexandria_wd	AlexWebDesigners	random
AlexFeyenoord	Alexander van Es	random
alexfryer3	freerunner001	random
AlexLopez_79	Alejandro López	random
Alfawhy19	Wahyu Alfarobbi	random
Al_Ghareebah	Stranger	random
aliceconnellxox	Alice	random
alifhanipX_D	(҂'̀⌣'́)Hanif	random
AliiCiia_Martin	Ali Martin ♥	random
AlimRedza	Alim Redza	random
alin_140799	♥ Hɑekɑl_Λlin ♥	random
Ali_nees	Lacinho	random
alisha_mercer	Alisha	random
Alison_m93	Maéva MaPrincesse ♡	random
AL_MANAL98	м̵ɑиɑƖ☆.	random
AlmutebA	A.saad.	random
alsowtnews	صحيفة صوت الشباب	random
alvaroortegamor	alvaro ortega morro	random
aly42fofo	الفرعون الحر	random
alyarahmayani	Alya R	random
Alycia_Pm	ICE FREESTYLE	random
alyssaholmes	Alyssa Holmes	random
alyssa_petruski	Alyssa Petruski	random
AlyyCorrea	Aliiii	random
_Am_Ane	Yuzu..*	random
amarmil	Abel Martín	random
amattock	Andy Mattock	random
AmberBrockish	Bleezy	random
amera3zez	أميرة ♚	random
amichi414	m(ii・c・h)i：Aume・みぃち	random
amingqq	긔승원별글봐줘요	random
amirolidaham	Mohd Amirol	random
Amlmutairii	.	random
ampiprades	Ampi Prades	random
AnaAdyra	iffa nadirah	random
anabelrv2	Anabel❤	random
anammdasilvaa	ANA MARIA MONTEIRO D	random
ancodayon	iPhoneあんこ	random
andall_ray	Randall	random
andariputrin	Andari♔	random
andy_kobari	こばり	random
aneme777	ﾎﾟｸﾍﾞｲ	random
ANg0MaNg0	Gussy	random
AngelsandDEVOLs	Devv	random
AnimalSiempre	Animal C. Siempre	random
Anime_Voice	AnimeVoice lite	random
annaanderson6	anner	random
AnnaCabanna_xx	Anna...	random
annecookie_1D	☾anne ♓|→188←	random
AnniisaJasmine	nis。	random
AntonioVelzque2	Antonio Velazquez	random
anya1123	あにゃ(クズ)	random
AoiCLL	蒼衣	random
aosd2011	AOSD'2011	conference
aosd2012	aosd • 2012	conference
aosd2013	MODULARITY: aosd•13	conference
aotuki2013	蒼月	random
Apatterson6	Ashley Romero	random
ApoAyasky	あーぽん@ミルクケーキ	random
aprilliasenna	A.Putri Sennarista	random
AR15th	元プロ六でデブのこあり	random
arab_kpoop	اخبار الفن الكوري	random
AragamiDice	荒神ダイス改=͟͟͞͞('ᾥ'=͟͟͞͞	random
ArashicSoccer	ゆうや	random
a_r_c_t_i_c	ざべす@あけおめ	random
Ardiansyaharis8	Ardiansyah Aristama	random
Ardiarsari	NuQi Sari (´▽`ʃƪ)	random
ArianeLefevre	ARIANE ET CLARISSOU	random
arielnoah_ofc	Ariel Noah	random
arielpanjaitan	Ariel	random
aries_b2	ありえすb♡煩悩ØF	random
ariston29	Followback Yah ♥	random
Arjwana_14	Arjwana ~	random
arlrexhaj	Engjull	random
aroeldwibel	ARUL	random
ars_tmp125	ぽりす@非営利	random
asaadalhayeil	اسعد الحايل	random
ASAP_2013	ASAP2013	conference
AShimkova	Anastasiya Shimkova	random
Ashley________	LilBoss ❤	random
ashleysimonay	le greatest.	random
ashlllleigh	Ash Pom	random
_ashz	اشواق الزهراني	random
AsmaAlshammary	أسماء بنت م الشمري .	random
asniedaaziz	NUR.ᗩSNIEDᗩ.ᗩZIZ	random
asrarkoo	أسرار	random
asrialfia	Asri Alfia Sugiharti	random
AstriNadia2	Nadia	random
AtikaSyahera	Ahmad Musa's ♥	random
atood20111	رضى الرحمان غايتنا	random
auliasuwandari	R Aulia S Kusumah	random
Aun_Auning	น้องอัน	random
aurelie_1207	NOV./\ ▫️	random
AustinGallucci	Kenshi	random
aveli93	Angela Velilla	random
AvonTammy1	tammy norton	random
ayabuabed	AyaAbuAbed	random
ayappage	あやの	random
aycangulmez	Aycan Gülmez	random
Aye_BreezyMeDwn	#FreeTaedoe❤	random
ayelovemejustin	lottee	random
AysayaCanlas	Isaiah Canlas	random
ayunithahanimoe	ayu nitha hanimoen	random
aziz6fontas	aziz al ibrahim	random
azka_ad	azka aditya putra	random
babyboeck4	Cori Boeck	random
Babyhavefun	ℛℯƅℯℓℓℯ ℱℓℯυr ♔	random
BadoorAlam	♚BEE*	random
baitizulkifli	Baiti Zulkifli	random
bakachinnnn1_6	ゆっちΣ (´Д`ﾉ)ﾉ	random
bakutaros	貘	random
BalkonSepeti	MÜFF.	random
balqisnnn	Balqis Nadila	random
BARBIEEevansyah	♀ Ka'Tasyaa ♀	random
BasedOlisa	▫️	random
bbaggung788	무적의용사 김빠꿍	random
BBG_Vip	BIGBANG GIRL ♛	random
BCYoungblood_23	Bryce © Youngblood	random
BdmgMillz	YuppieMillzHoBB	random
BeanieOnBieber	believe	random
Beccageorgiaaox	old account.	random
Beccybeexoxo	Beccy Anderson	random
BechiniFlavia	bechini flavia	random
bellroseh	B	random
Bender4life	AndreyShtrakbeyn	random
bent_alderh	بنت_الديره	random
Bernard_Jonson	Bernard L. Johnson	random
berrymelonf	地面にめりこんだ	random
BetheMarchant	Bethe	random
bethereforhim	✼	random
beth_w0t	beth	random
beymerins	BEYMER İNŞAAT	random
BeyzaGalin	Beyza Galın	random
BG_Sofia	Sofia	random
birdlooooooove	むぅ鳥もち	random
biswas_titas	Titas Biswas	random
_BitchImGreat_	IG=justasia_	random
blokkerrr	hans	random
bloopbloooop	バーニー ♥♪♫	random
_BMJ	Biancaa.	random
bmvc2013	BMVC 2013	conference
BMVC2014	BMVC 2014	conference
_bob_41	'Bad'Bob'	random
BobcatDane	Dane Sollitt	random
BonsaiiPkuhaffa	Tata	random
book_off94	白緑@腐女	random
boulaadasmoha	MO MO	random
boy_bobs	NB4LIFE	random
Breylexander	Brey Alexander Tan	random
Brianah_G	Brianah Grant	random
brittomrapha	Raphaela Brito	random
Broown_K	12 janvier, à suivre	random
brunams__	Bru	random
bruno_luver72	idk	random
BsrKth	Kübra	random
Bubbles_Inc	tina	random
budakris1	Hugo Martinez	random
BukiLavigne	Buki kiki	random
bunga1504	Bunga	random
BungaTS	Bunga Triwahyu	random
BWGBOY5020s	K-BLACCKK™	random
bx_top_xt	cool탑	random
byakkou_pksp	白鵠	random
c1130j	(o･ω･)ひろこ	random
CAiSEConference	CAiSE Conference	conference
Callmecoraliee	coralie	random
_CallMeJUICY_	toojuicyyyy	random
_camii23	A$$♔	random
CamilaaLoza	Cami Loza	random
camilleubn	mini urbain	random
caprisella	ghost writer	random
carambanic	nicolly	random
CarissaArdi	Carissa	random
Carla_MorenoD	Carla Moreno	random
CarlaSiierra19	CARLASIERRA♥	random
carloota8	Carlota Gómez	random
castl__e	アスおじ	random
catalinaaspe	cata	random
CatarinaNAlves	✨ Roooobz ✨	random
cat_bee_	Catnip	random
ccgrid2011	CCGrid2011	conference
c_d_g_a_	じゅん	random
ced_bright03	Cedric Jr.	random
CeeliaColin	Célia ✌️	random
Cess_Soledad18	Princess Swiftmas ♛	random
chaelin__xxi	GZ.BITCH	random
chaisarputriii	S. Chaisar Putri	random
CharliesIbiza	Charlies Bar Ibiza	random
charlylgns	CHARLY	random
char_staines	Charlotte	random
chatte_km	つんこ	random
checkkmaflow	22	random
cherry19090	cherry	random
CheyenneLeiani	Cheyenne Leiani	random
chi__124	もりちゆ	random
chi2010	CHI 2010	conference
chi2011	CHI 2011	conference
_ChickCoucou	ひろな@クズで〜す	random
ChiEffin_ViXen	❤iLove ChastityJewel	random
chiiemon_17	ちぃちょる。	random
chii_hs	ちひろ'14	random
chiiisax23	森 千紗	random
chi_kuuuun	ちーくん松下アニメイト大宮天王寺	random
Child_Le	Krotkovaa	random
ChildsOfTheRain	Children of the Rain	random
ChipotleTwins	△	random
Chistesrisaxd	Genesis	random
choco_2828	きむ	random
ChrisTait123	Chris Tait	random
ChyntaAngeL	ChyntaAngeL	random
CiaraMurz	Ciara Murray	random
CIKM2011	CIKM2011 - Glasgow	conference
CIKM2012	CIKM 2012	conference
cindyperezx	chloe	random
citraanggrenii	Citra Anggreni	random
citrafinishia_	Citra finishiaNA▼	random
Citron1128	°+♡:.花澄.:♡+°	random
CK_GaemGyu	ChintiaJeklinWatung	random
ClaraMrtn98	ClaraMaïssa	random
cl_nat	NatasjaCL	random
cloudpudding	peiyun	random
C_McMac	C Mac	random
CMKelman	CM Kelman	random
Cobalt_fuck	[계폭]Cobalt(-@Cob_T)	random
CocaineCaRaha	GreenLantern	random
ColezyHitsBills	| Bark Colezy |	random
colt2010a	COLT-2010	conference
co_minkk	cominkk	random
ComprentuPueblo	Compra en Tu Pueblo	random
ConneryKeith	Keith	random
connieegan94	Connie Egan	random
cook_ago_gate	cook_ago_gate	random
CoretanLuka	Liaa	random
corewalker	walker	random
corrie_ellis	Corrie April Ellis	random
cosukaoral_ce	cosukaoral-ce	random
CrisHorche	❀♪☮Krisia ♡	random
crp_leehi	Evi Lockhart	random
CSCL2013	CSCL2013	conference
cscw2010	CSCW 2010	conference
cscw2011	CSCW 2011	conference
culha_g	emine çulha	random
cumonzayn	sOPH¿	random
cupofgeorge	deni	random
cure_gift	ぎふと＠キュアギフト	random
cure_meat	しりこだまの咆哮	random
Cvndyxxx	Unx	random
CVPR	CVPR	conference
cyobincyobi	ちょびん	random
D4rKn1ght64	Josh	random
d__64	doaa Abdulmohsen.	random
DaaianaGalvan	Daiana Agustina	random
DaeAbsolute	D.A.E.H.Y.U.N	random
_DaiiFernandez	kochidiosaunicateamo	random
Dalty_Saltyy	Dalty	random
DamonMySire	Dalaric Lives On	random
DanialSkyes	DANIAL SKYES	random
daniellelobozzo	Danielle Lobozzo	random
dannyan_bot	だんにゃん	random
Darcy333	Mayor	random
DaviddCoombes_	David Coombes	random
David_GaDa	David García Dávila	random
ddakkeung	따끙	random
dearpaynie	marcel	random
DeborahNbl	D.	random
debyjuma	DEBY JUMATIKA	random
decemberrbaby	hannah	random
decky_rd	D©™	random
deepak_samra	47	random
D_egha	Loading . . .	random
dekcupid	-dekpid-	random
dekyoy	strong_	random
DelaSalsabila	Dela salsabila	random
den_den_insect	電	random
Den_Marchenko	Den Marchenko	random
dessytriska	dessy triska	random
DetruzIvemey	Makatang KwaTro FeyM	random
DeuceHoney	honey crack	random
Devianitaaa13	-	random
DGtoniXD	Toni :3	random
dhea_shendy	Deo	random
diankaok	D✨	random
DiazCarolina12	Carolina Diaz♡	random
dideewii	Lywi	random
dinaranggraeni1	Dinar	random
dindafahirah	dinda	random
DingDongDingEn	Chua Ding En	random
dinitapn	Dini	random
dirtyharry71	L'inspecteur Harry	random
dirtyyouth	erica boyle	random
divya_16_	Divya	random
Diyantita	Diyanti Baay	random
djsharil	awang mohd sharil	random
dkcaballeros	Cyan Lounge	random
dknayk0406	♡ａｙａｋａ♡	random
Dobicy92	DobiChan[SH]	random
DoctorRuba	Ruba	random
_DopeAssLesbian	Bossy'❤	random
dorropu	チョコレートくん	random
DoseOfChelsea	22 days	random
dotddott	몰라요-_-	random
doyo_online	_ q:) 도요	random
drakkarkent	Qusyairie_zainal	random
drhOVOdes	DreVon Rhodes	random
DrNamG	د. نامق ،،	random
Dr_Zafar_Taha	Dr.Zafar Taha	random
Dsmith1854	Dalton Smith	random
dsn_2011	IEEE DSN2011	conference
DSN2014	DSN 2014	conference
DSTA_nl	Dutch State Treasury	random
DTaylor_34	Donovan Taylor	random
D_too_crayy	DeMaria Williams	random
duranta114514	デュランタ	random
DVWLD	Devywulaan♚	random
dwiOktaviary_	VIA	random
__dystopia_	сахарный крендель	random
EACL2014	EACL 2014	conference
EbWiddowson1	Ebony ✨	random
eccv12	eccv12	conference
echelle417	エシェル	random
ecis2011	Tuure Tuunanen	conference
ecloure	えくろうれ@一揆266 戯書429	random
ecoop2011	ECOOP 2011	conference
ecoop2012	ECOOP 2012	conference
ECOportal	ECOportal	random
ECRTS	ECRTS TC	conference
edbraddock	ed	random
edvinkray	Frenky Smasher	random
edytanabilah	Mr.Zio	random
Eguraldia24	Eguraldia24	random
ehsasstefla	إحساس طفلة	random
eiyard	Eyad	random
Eking17	にけ	random
Elchinolocoz	SoNnY™	random
elesa000	Bashayer Ibrahim	random
ELigneres	Emeline	random
Ellenkate9	EllieWellie	random
ellennongol	ELLENG WRISABA	random
elliotfenton_94	Elliot Fenton	random
ellydunsterr	Elly Dunster	random
ElveaUy	Tommo	random
elvirabrigitte	brigitte van wees	random
EmadAljilani	ツ العُـمْـدَة	random
e_malet	Esther	random
emlewissss	emily lewis	random
emmanowo_xo	emmma	random
EnemyKo	Ian ko	random
ENERGYPROMOTION	DONT LEAVE ME	random
ennaeillib	Billie	random
enpc1014	Ena	random
ER2012_florence	ER 2012	conference
ErComodino	Luna Lovegood ♥	random
EricDankers	Eric Dankers	random
esa_kanija23	angela Giraldo llama	random
esanchezpelaez	Enrique Sánchez	random
Eshyfadillah	Ncy	random
EsmeHolden	Esme Holden	random
EunHaelovemcz8	tomooo	random
eurocrypt2013	Eurocrypt2013	conference
eurograph2013	Eurographics 2013	conference
Eva_Gene	Eva Gené ||*||	random
evoleTemmi	temmi iljang	random
eykamiaa	♡ HAPPY ♡	random
EzhyOzawa	••• Ms. Rempong •••	random
facebook	Facebook	company
fadil_tama	M Fadilla Pratama	random
fadlimuhammad11	Fadli Muhammad	random
Faesyko	fayruz afra	random
_fafo3	سلمى	random
faisalgore	Faisal	random
FajriansyahD	Muhammad Fajriansyah	random
_Fans_Larry	Fans Larry Hernandez	random
faqihomaulana	Faqih okta maulana	random
Fatinayunni	g'z	random
Fazhiraaaa_	Izzul bukan Ijul !	random
febry_maryani	FeMa	random
feliciaxx00	Feleesh	random
fernandaBcerril	Fernanda Becerril	random
fernandocd97	Fer calero	random
fittri_99	Fittri Ninetynine	random
FlorBelfiore	105 ♡	random
fony201	αғиαи	random
FranBlancar	♕KeepCalmAndCarryOn♕	random
FranciscooArauj	Franciscoo Araujo	random
FranMcC21	franchelle mccarthy	random
freetevoohoee	RipPlayaAssCass$$$	random
French_Dub_KNO	▲HARD DARLING▼	random
friskylirry	♡ erin ♡	random
FSE2010	ACM SIGSOFT FSE 2010	conference
fse2014	fse2014	conference
funami1046yui	白堊	random
FxckJesse__	Jessee	random
fxcklukeyy	☹baniel☹	random
Fxrhxn	mfbh	random
GamaRamadan	Ramadhan, Gama	random
Gamzealin	Gamze alın	random
gamzeninkankisi	BUKET	random
Gary_kins	Gary Martinez	random
GbobMontana	Big Serg.	random
GELEH66	غلا الغامدي	random
GemsandCharms	GemsandCharms	random
ggjeseey	妍	random
ggjeyo	Jeyoh	random
GGneetubrauer	Neetu K. PB	random
ggrks_beruse	今ベルセのこの頭のことなんつった!	random
GGUNYIN	-	random
GH14argibonista	Siempre Argi!	random
Gh2Mansour	الصقورية	random
GhaGhaMorshie	Rarro	random
ghfoor8855	GнfoOя •	random
GIOSETTE2013	GIOSETTE	random
GitalYigithan	YIGITHΔN	random
Gitaningrum2	Gitaningrum P.H	random
GitaPtiwi	GITA PERTIWI	random
Gizemkahramaaan	Gizem Kahraman	random
glitterbot_	☆ ☽ Jenna ☾ ☆	random
GminaGniew	Miasto i Gmina Gniew	random
gnashino	ナッシュ夫人	random
GodArmani	Too Cool	random
Godfather172	ابو هشام	random
God_Given_42	KEEP CALM IM 18!!!	random
gok529	ゴック＠(ºゴº)	random
gomatamago73	いのごま＠ごじら	random
gonzux2035	GONZUX / ガンザックス	random
gorelik_vasiliy	Gorelik Vasiliy	random
_GothicCupcake	Sarah Elizabeth	random
gozdegokcan	kavunkokusu	random
GraceGraceAbitz	HappyDiabeto	random
gregoirehbc	Grégoire Hbc	random
GregoryFerrera	Gregory Ferrera	random
GRizzly_TT	Timi Thomas	random
gruppa_vabank	Группа Ва-Банк	random
gryffindorliam	vero loves liam	random
guchioYT	かんた(’・ω・｀）＠Exia。	random
guldensozer	Gülden	random
guloran	Gül	random
Gutto_x	Augusto ⚡️	random
gxldskies	♕	random
gyoniku17	魚肉@17日誕生日だよ	random
haams_d	Haams♥alro0o7	random
hafizulhadi3	hafizulhadi	random
Haiyo0F	вίит п̵ιƨн̲̣̣αмƨί_н	random
hakunduraci	Helin Aylin	random
Hakurokai	Raynaldi Adityo	random
haky_666	テンコ＠ka-yuさん命名	random
HALLOnoMORI	ハロ	random
Hannahlane18	Hannah Mosbarger	random
HannahLouise_UK	Hannah Louise Palmer	random
hannahsandy_	hannah	random
HannarinzStore	HannarinzFashion	random
hanvaley	han	random
haramakiichiba	他餅	random
haroldnacino	haroldnacino	random
harrietbox1	harriet box	random
harryeek	erin	random
harryttoxic	bad girl	random
harukataka	harota@ギター初心者	random
Hayley_1995	Hayley Hutchinson	random
hayleyquinn1990	hayley quinn	random
hazakuraP	ハザクラ	random
HdadSanEsteban	Hdad San Esteban	random
hdawh55	Rawan★	random
hdhm410	ヒナボルス・オリグチフォリウス	random
heavwen	Rynwyll Mascariña	random
HeelThekra	The human bean	random
HelgaaEghaa	♔Dit's	random
hell_hellnia	粗品	random
Hello_daisyy	daisy marie	random
HemoHenry	IBRAHEEM ALFARIS	random
heranai	絶賛増殖中	random
hestyhk	hesty kusuma	random
HeyNaaastya	Настя Набоко	random
hiccup_botkr	히컵 호렌더스	random
hidungandin	Andina rizky	random
hiemeru	ひめる	random
higemoyasi	ヒゲもやし＠ナガヤ	random
hiho_silver	ぶちょ	random
HiiLoueh	japko	random
hijode_toreto10	♥♦GuERry #13 ♣♠☆♬	random
hildatrID	Hilda Tri Damayanti	random
hinamarimo	Emi	random
hipcconf	HiPC Conference	conference
hiris420	ﾟ:.+☆うたは☆+.:ﾟ	random
hisa_so	そうLOVEひさ	random
HISmiho	Miho(・ω・)ノ	random
hizaki85	フランin眠り姫＠らぶらいばー	random
Hizumii	pedrenrique	random
hizz_one	MNHZA	random
Hmthaythay	Thaynara Silva	random
holly_yuan	Holly Yuan	random
homizh	Tagreed mohammad	random
HonduranHoney	Jacquelinn.	random
HoneyBear_bot	くまー	random
Honsoucillo	moe cuchillas	random
hotmail_360	توتو	random
HotMobile2011	HotMobile 2011	conference
ho_zuki	さば	random
hpca16	HPCA-16	conference
HPCatDell	Dell	company
hqa_20	حِكَايہہّ ' `..♡ и	random
hrag_ssz	maro	random
hrewthme	 	random
hsus66	ام عبدالعزيز	random
htimsnimsay	yasmin	random
httpspauloc	Anne	random
humasexyrose	菊池風磨	random
huubkrol	huubkrol	random
I3D2013	I3D 2013	conference
I3DCONF	I3D Symposium	conference
IaanMartinez	Ian	random
iagonc	Iago Caldeira S.D.C	random
iAriaanaGrande	ʕ•̫͡•ʔ Lah Jèéssý'ýý	random
IBM	IBM	company
IbrahimAliPh	Ibrahim Ali Ph	random
icac_conf	icac	conference
ICALT2012	ICALT2012	conference
icaps2013	ICAPS 2013	conference
ICCAD	ICCAD	conference
icde2011	ICDE 2011	conference
ICDE2013	ICDE 2013	conference
ICDM2013	ICDM 2013	conference
ICDMsocial	ICDM	conference
icesexy_	sica	random
IchaRahyarnicha	♥ICHA	random
iClAaM	»SHiKa«	random
icme2011	IEEE ICME 2011	conference
ICME2014	ICME 2014	conference
ICML2010	ICML 2010	conference
IcmlConference	ICML Conference	conference
icnp2009	ICNP2009	conference
ICPR2012	ICPR2012	conference
icse2012	ICSE 2012	conference
icse2013	ICSE 2013	conference
ICSEconf	ICSE	conference
icsm2010	ICSM 2010	conference
ICSM2011	ICSM 2011	conference
ICSMOrganizers	ICSM 2012	conference
idole_e	Elodie Dmnr✨	random
idolnn	アイドルン（アイドルと愛国）	random
Idonothavedream	おさょ	random
idontsmoke_	J1	random
iEatHypocrites	janine x	random
IEEEGlobeCom	IEEE GLOBECOM	conference
IEEEICC	IEEE ICC	conference
ieeeICDE	IEEE- ICDE 2012	conference
ieeeicip	IEEE ICIP	conference
IEEEIM	IFIP/IEEE IM 2013	conference
IEEELCN	IEEELCN	conference
ieee_re	RE 2014	conference
IEEESSP	IEEE S&P	conference
iFuckTwitR_Hoes	Feb.O6 | #PoohDay! ❤	random
IgorGH141	IGOR, mi GANADOR	random
iguuaeng	ละมุนอะเธอ*	random
iheartyed	Yeddah Santiago♚	random
iholdtheworld_	Em'	random
ihtbmitf	里奈	random
Iido_Ismail	Just Iido	random
I_ikinkakyong	Yebbit ™	random
IJCAI	IJCAI	conference
IJCAI2013	IJCAI-13	conference
ikemen_renko	イケメン蓮子bot	random
iketakudaya	池田 拓矢	random
IL0V3Janoskians	נαяηα ε∂ωαя∂s	random
iLadySnchz	-16•.★LadySanchez☆•.	random
IleanaGts	XX-V_XXXI-VII	random
ilhamfakh	ilham fakhruli	random
iloveJCCafe	iloveJCCafe.com	random
ImaDeeva	Deevvvaaa	random
imjayvillanueva	Jahaziel Villanueva	random
imkansizkiz	Clara	random
ImmortalRaw	Arwa	random
Ims_917	アイムス@くまムス活動中(๑´ㅂ`๑)	random
imsocalum	pls calum hood	random
imthatgirlxox	Nikki Alcini	random
imWarriorAngel	McDonough	random
Ina_RRina	Rina	random
indi_Djhaneko	indi ibrahim pali	random
IndigosProphecy	I am God	random
Ines94_gl	Inés González ♥	random
INFINITEinspir9	มึงเสร็จกูว เย้เฮท!!	random
Infinite_xP	Brian Infinite	random
INFOCOM_14	INFOCOM'14	conference
INFOCOM2013	IEEE INFOCOM 2013	conference
Infosys	Infosys	company
ingrid_wr	Berg Katse~	random
ininovi	Novi Eka Purwanti	random
intel	Intel	company
intermedia_ru	InterMedia	random
I_ortegga	dat seun is ortegga	random
iPan_Wyc	ไอแพนวาโยคลับ.♡	random
IPDPS	IPDPS	conference
ipsn2014	ACM/IEEE IPSN 2014	conference
ipv6_speak	ipv6_speak	random
iRealYoungBae	Teddy	random
IrhaaaLo	Chatrain Lorraine M	random
irnaannisaa	IrnaAnnisaF	random
i_rock_Jordans_	Marley G	random
irvansandriaa	Ivan Sandria	random
ISBI12	ISBI 2012	conference
ISEC2013	ISEC 2013	conference
ishiyoshi21	いっしー	random
IsleyyMane	Skrooby	random
ISMB2013	ISMB2013	conference
Isnaa11	Nana	random
ISSTA2012	ISSTA 2012	conference
IsuzuHana	K.G.D.P五十鈴華　	random
iswc11	ISWC 2011	conference
iswc12	ISWC 2012	conference
ISWC13	ISWC13	conference
iswc2008	iswc2008	conference
ISWC2010	ISWC 2010 Conference	conference
ISWC2011	ISWC2011	conference
ISWC2012	ISWC 2012	conference
iswc2013	ISWC2013	conference
iswc2014	iswc2014	conference
ISWCNET	ISWC.NET	conference
ITiCSE2013	ITiCSE 2013	conference
ITICSE2014	ITiCSE	conference
itsdannycuhh	le fagg ^o^/	random
its_emma_	Emma	random
ItsMuhdShazwan	Shazwan	random
itsYssaVocal	Yssa Clarin Vocal	random
ituki_ryu	樹　劉	random
iui2011	IUI 2011	conference
IUIConference	IUI Conference	conference
i_unico_o	しろザリみね2号	random
Iv_I_M	Ivy	random
iwatekko_1986	岩手っ子	random
IzzahNazurah_	Izzah	random
jaadedestini	jade	random
jacebemyangel	ex @niallerismytaco	random
Jacinta_MS	Let me tell you...	random
jacob_jp	ゆうき	random
JamesRKnight	James Knight	random
JamieADykstra	Jamie Dykstra	random
JanahiMachiche	MachicheΩ	random
jannettebee	JDAWG.	random
JasminChambers	JC	random
jasmineangara	Jasmeng	random
javii8996	JAVIER GARCÍA	random
javito_mojados	Javier Nuñez	random
jawirrputra	Agung Trilaksana	random
JC_vWyk	JC van Wyk	random
J_Deer	Josh Deering	random
Jelmer_RMA	Jelmer Theune	random
jencrabtree_x	jennifer-x	random
jennabeenawinna	Sugarplum Fairy	random
JenniferAlcant1	ĵeηηιŦεπ'αℓ¢ɑηтαяɑ 웃	random
jeprivengeance	coffee omelette	random
jesperminecraft	jesper vv	random
JessicaVelasco_	π	random
Jhosuxx	El Alien de Britney.	random
JiggyJiggaaa	Raja'a	random
jilbaxter	Jil Baxter	random
jjarvisjosue	Jarvis Josue	random
jkun_lav	つかさ坊っちゃん。	random
jmjc2012	Chino 76	random
Joanne_voltaire	Joanne voltaire	random
JobQuezada1	Job #2	random
joemelvv	IG: j0emitchell	random
johann_0921	佐藤竜市	random
johnnydcfc19	Jonathan campbell	random
jojospence	Jode Spence	random
Jokerr_facee	PSYCOVILLE †	random
joleeeenss	Ma. Jolina Magdangal	random
jorgeandres10_	Juicy Jorge	random
JorgePedron	Cacho imbécil	random
jorguitocapo	SashiiTeAmaMucho♥	random
joscar930	Carlos Garcia Blanco	random
JoseBustos17	«yampi»	random
joshwadecomedy	Josh Wade	random
joygayu	Love SungGyu	random
JpBuzzedVideos	JapanBuzzedVideos	random
JRKINKI	JRKINKI	random
jsksmluuuv	ふうこ ✡ 松本	random
JudeSally	Alex Turner	random
judithgreenX	Judithgreenx	random
jumaremilkaw	JumaRemilkaWinansyah	random
June131	`sjunelf.	random
JuninhoLipert	Juninho Lipert	random
JuniperNetworks	Juniper Networks	company
Juritan3	ぢゅりたん	random
just4artists	Looking For Artists	random
Just_Fab	Fab	random
justin20072007	justin emmerson	random
Justregina13	♡ & ♡	random
JuuliaYogo	Ju ✨	random
K1v3n5s	K1v3n'st De Riva	random
kagerou_cat_bot	カゲロウデイズの猫bot	random
kahanee	kahane noeschi	random
kaitlyn_lane96	Chewie lane	random
Kamsoo__	- Kamso	random
KardiSantiago	850✈️559✈️334	random
karenstanley76	karen stanley	random
karon1211	さいき	random
kasiko069	かしこちゃん＠夜はいない	random
kassielalondee_		random
kasubuta0116	鈴木花純✿あいりす	random
KatLoDun	Katie Dunleavy	random
katrinaish_	Kat Sup	random
kawahara38	薄河原饅頭	random
kawther1_2	it's kay	random
kay53_	كآديجآ	random
KayKerney	K.T	random
kayleesas	insta : kaylee_x_	random
kazua_rootfive	かずあのるーふぁい専用垢	random
kazunoko_mame	さかな@究極に低浮上	random
kdd2010	ACM SIGKDD	conference
KDD2011	KDD2011	conference
kdd_news	SIGKDD/KDD News	conference
keetybertoldo	Kettlen Bertoldo	random
keik_y	恵	random
keinnncom	けいん	random
keishamaulita_	keisha maulita	random
KellyAShaw	Kelly Shaw	random
kelly_fentyy	Kelly	random
kendaguntara	Kenda guntara	random
kerajinan_fs	kerajinan fashion	random
ketsscristina	Ketlyn	random
KevinPinto__	K• †	random
khalid13_	khalid A al anazy	random
khallilgrant	Khallil A.C. Grant	random
KHK2421	KHKQ	random
kiiserok	きい(。-∀-)	random
kik_kane	Kik_Byun	random
kikuzunoko	焼き芋ﾎｸﾎｸbot	random
kikymassi	QR	random
kilzara	Renee Ladd	random
KimCHOfficial	Christophel Sampouw	random
Kimimd900	Kimi Tayag	random
king_f6o0mi	♕King‘F6Omi♥MnAya	random
king_flw	ملك الفولو	random
KisforKevinn	ⓚⓔⓥⓘⓝ	random
kitkaatx	gay cheese	random
kkluv_arare	あられだよー。	random
KLialadiyantii	KL	random
kmnrnsny	脱ニート願被まるせい奴	random
K_mothershed	Krystle ✨	random
kntnn_d9_24t_h	あーちゃん☆AAA専用ｱｶ	random
komi_25	こみ	random
korosukebuuuuuu	ころすけ。	random
kouhaifuwa_bot	後輩不破	random
koza_714	小座	random
kristeldelmundo	staying for kidrauhl	random
kristianbarita	Nama saya tengik	random
krylovaaaa	Анна Крылова	random
Krysismyname	K R Y S ♥ 1D	random
kspmp0218	かほりん✍1/11생일	random
KTSI801Mta	しょーた≧∀≦	random
kucarail	✩真綿木游✩	random
kungmarten	marten br	random
kurarin_p_kun	RIN@1/11 1/12金沢マン	random
kurenai_ageha	Kaho.	random
kuriyasana	みゆ	random
KurniaRestuZ	Kurnia R. Zainal	random
kuroteru042	黒テル＠年中無休で頭の中祭り	random
KutieeLiciouss	❤ Christy ❤	random
KY00RIZER	ポンデライザー	random
kyaokyaoon	薫音	random
Kyle_Dickhaus	Kyle Dickhaus	random
k__ymcbb	芋	random
kyotojinzai	京都府京都ジョブパーク　就職支援net	random
labzakigiybat	labzak i giybat	random
_ladyHF		random
Ladyy_Ballerina	Pardon_My_Dimples	random
Lailiaidinaa	Oma	random
laishelena__	Laís Helena	random
LAMAA_E	'LmΛ	random
LARAtheband	LARA OFFICIAL	random
_LarissaGaiato	2 th november ♡ ‏	random
LarsDyl	Dylan Larson	random
lau_Jsc	♥♫ Laura 'SDalma ♫♥	random
lauragarutti_	Laura	random
LauraOrtizR5	Laura Ortiz	random
laurensiaput	P U T E R I	random
Lauriensmit	Laurien Smit	random
LaurinMeyer	Laurin Meyer	random
laurwilliamsxo	Laura Williams	random
lcn2009	LCN 2009	conference
lctes13	LCTES conference	conference
leemg2000	구름	random
lee_seeun	李世恩	random
Leitoojedaa	Leonel Ojeda	random
LeonardusGP	Pramudya	random
Leon____bot	レオンbot	random
leotart84	Jona-Ann	random
lesslylove	Lessly Moreno ⚓	random
Leti_Moran	Leti Morán	random
leximeehanx	Alexa Meehan	random
lexlnge	Chocolat Blanc	random
liia_amalia	Lia Amalia	random
Lik3MIKE_	°MIKE°	random
lilacbeagle	☀☀elizabeth☔☔	random
Lil_Herrera_x	Jennifer Herrera	random
LilyAndiana	Erlian~	random
LinkedIn	LinkedIn	company
liongurdians	斯波陽人@Freeで盛り上がりたい	random
lipcho	Lipcho	random
lisettebaybeexo	Lissy. ♡	random
Lissaa1D	#NiallsWhore	random
Lizzyst10	Lim Jiyoung	random
ljhbl	Lian Habla	random
ll_Benz_ll	Benz ♬	random
_LMAC	#LMAC	random
LnaZafra	Elena Zafra	random
lofortefabio77	La perfection	random
loicfox	éternel insatisfait	random
LolaKabuki	Lola Kabuki	random
Lonelinne	Анастасия	random
loseitnoworelse	Earning My Body	random
Louise_2010xx	Louise Warren	random
Love_1Dream	Dreamer ∞	random
love_angel_muse	Alannah	random
loveDJ12	Lovely May	random
loveightkj83	あかねーる∞腰振ってほしい	random
loveismeatba11	（Love is）肉だんご	random
LoveOfHaters	Sara Odair.	random
Loyykkab	M.A.F♫	random
loz09	Laura banks	random
Lpuspitas	Meylinda Puspitasari	random
Lsmulfani	vanni	random
LSTDtwit	LE STRADE	random
lucia_nathania	Lucia Nathania	random
lucremontiel	Lucrecia Montiel	random
lucydal_	이효림	random
LuisMcMuffin	∆Luis McMuffin∆	random
luleuhan	kei	random
luluensorx	lulu	random
LuqmannnHakeem	Leo.	random
LuuIsaurralde	Luchi	random
luumontero	Luu Montero	random
lv_sj_elf1015	chihiro#えるぷ	random
lylyenggar	♥ Lyly Enggar ♥	random
M0nikiki	MonicaQuiñonesPlaza	random
m1_cha_n	みさみさ☆	random
maaribee	mar e ana	random
maba11eta	まや	random
ma_chachan	うじの	random
macherie628	夢宮しゃな☪․*	random
Macjkbot	マックで隣の席の女子高生がbot	random
mag_2608	貫通レーザー中毒者MAG	random
magopopo	むさしｯｼｰ@なくもんか。⁾	random
mahiruka	真昼@勉強頑張れわし	random
mahyaser1	mahy &aser	random
maissalem	mai	random
Malikks_World	Fly Malik ♒️⚡️	random
m_a_lucker	Жена Курта Кобейна	random
Mamoun6920	أبو فراس	random
manddds	Amanda M	random
manformurder	кроули.12	random
maplesyrup_1005	岩佐楓	random
Maram_almuhana	MA.	random
marcdijkstra95	Marc Dijkstra	random
Margaretteee	yana	random
margot_zhlnl1d	SAVED @5sosfaggs	random
marhellen62	Елена Мариничева	random
MariaaaaaaAlli	Alli Sisante ❄️	random
_MariacuervoG	MaríaCuervo.	random
maria_dewanto	mar	random
mariel12369	Bonitaaaa	random
MariluuRamirez	Marilu Ramirez	random
MariosKozis	Marios Kozis	random
MarKalkman	Marjolein Kalkman	random
Markitos_NOB	Markito§	random
MarkOKelly_	Mark O'Kelly ⚾	random
maryanna3243r9q	Maryanna Nicolazzo	random
mary_ann_maid	メアリアン_bot	random
mascots	MASCOTS 2009	conference
mash_cheburash	Masha	random
MasperoLove	العندليب	random
master_mn	徳川まつーらり	random
match_humans	はすはす	random
Matiquemeero	Mati de leii ♥	random
mattaitken_	Matt Aitken	random
Matt_Young92	Matt Young	random
Maulidaap	Maulida	random
maxxtothemax	Maxine Gregorio	random
_MayAhmed	May✖	random
MayangPutri3	merriyam	random
MDanumihardja	Mien Danumihardja	random
MediaTek	MediaTek	company
meeghAmira	Amira Zakaria	random
mehmetbalkann	Mehmet Balkan	random
mehmeteminefe1	EMİNO	random
meLailurophobia	Imielda	random
MelissaSrt	SirotDeCerise	random
MelissaxxSwaggy	MeLissA!	random
MelWright73	melissa wright	random
meronxiah	yukameron	random
meta_guide_gh	Ghana Meta Guide	random
MEY_phua	MeyNaJ♡♥	random
Mezzamike	Michael Mezher	random
MicaAndrea1	MicaAndrea	random
MichaellaVairy	MickeyV	random
_micheeeeelle	IG : _prettymichelle	random
michhenriquez	• • •	random
michielfoekens	Michiel Foekens	random
Microsoft	Microsoft	company
midori_need	緑化@童貞黒髪眼鏡の会	random
mieko_ouka	ミーコ	random
Mighaa_mokk	WIFE ACONG'S	random
MiisooWww	وحدتن من هكالشمامره~	random
mikaelaottosson	Mikaela	random
mikaSouverain65	mikami souverain	random
_mikaylaramsey	ᗰikayℓa	random
MikeSayings	Brotha Guy	random
Mikkixoxoo	Mikki De Guzman	random
milawn_lackey	jay-duh♛	random
minato_port	ポート	random
Minkiky_	17데뷔기다려♡	random
mintkaoji552	mintmint	random
MinzKnows	Minnie Seibt	random
miraafanaa	mia.	random
Mira_Aina	B2UTY	random
MirTrevino	Miranda Treviño	random
Mishel_Golubeva	Маша Голубева	random
MissHawkins93	~Let go & let God.†	random
Mister_stiiven	mister_stiiven	random
miyama_BB	みやま茜	random
Mizz_K_Marie	Da Devils Wife✌	random
mkmkd_s	ミキミキ	random
mmgg_99	الفالوذج	random
m_m_mecky	メッキー	random
mmmm0713	まいちん	random
mmmmmiy26	たまねぎ、ねぎまになる。	random
MMoundous	Arab Money ⚠	random
_MMuratYazici	ElizabethIsMyLife	random
MMXI__	M	random
MNminion1412	MN minion.	random
Mo4Sho13	Mo	random
mobicom09	MobiCom 2009	conference
MobiCom2013	MobiCom2013	conference
mobilehci2010	MobileHCI 2010	conference
mobilehci2011	mobile hci2011	conference
MobileHCI2012	Mobile HCI	conference
MobileHCI2013	MobileHCI 2013	conference
mobisys08	MobiSys 2008	conference
MobiSys2011	MobiSys2011	conference
MobiSys2012	MobiSys 2012	conference
MobiSys2013	MobiSys 2013	conference
MobiSys2014	MobiSys 2014	conference
Modularity14	Modularity 2014	conference
mo_mmm	ｍｍｍ	random
momo11tgms	もも	random
momota19970717	百田日月糸広	random
moneearhoshaan	منير الحوشان	random
monilopesi	Mónicɑ	random
MON_pokemon1	MON@ゼクスもはじめました	random
monsterlove_70	⁰‹∞ıl̠[̶̠̄ ϻŏϞѕτ̃ĕэя	random
montoro_05	м.мσηтσяσ.~	random
MOoody_765	♥موضي تركي♥	random
moslam6612	محمد المسلم	random
mosmorse	มะมอสมุ้งมิ้ง	random
mostafasalim_	Mostafa Salim	random
Moudhy__F	موضي احمد الفيلكاوي	random
Mousemarion	Marion goodman	random
MphasiSTech	MphasiSTech	random
M_PIC94	M_PIC	random
mpvonuck	mmm	random
mrsnadal_	Chantal Reyes	random
M_S_AlThehaiban	Mohammed Salman	random
ms_jdmell	J.M.Taguiped	random
Mssz_Violleette	LASTBORN!!!	random
MsWhiteAngel27	45 days :( -isaiah	random
Muhd_AR	♥Itz My☺ BDY ☺	random
munan17	munan	random
mutooookun	ﾌﾞﾅｰ君	random
mxkah		random
my26xxx	ま や	random
Myha1090	まいは提督	random
MyLifeAsKeysi	Keysi.	random
myrianOdc	MDenis∞	random
MzBellaTeaXO	Queen Bella❤️	random
n0iado	mathe	random
n8greasy	Nathan Griesedieck	random
na1na1oe	なな　相互フォロー	random
NA34Y	طوق الياسمين	random
naacl	NAACL	conference
naahdanabilaa	nahda nabila	random
nachiyumi6500	なちゆみ	random
nadiapramesti	Nadia	random
nadr101	نـادر	random
nadyaamosqueda	Nadya Felicia	random
NafisaDewi11	Ichigo☀	random
Naimah_NBI	Naimah Ibrahim	random
NamwanAchiraya	น้ำหวาน เฉยเฉย	random
nanasemaru48	マッキー	random
nandamoraiis	NANDA MORAIS	random
naota0505	なおたけ	random
naporitan_1128	みーくん@ナポリタン松本	random
narryperfextion	5sos	random
naruko47	こるな	random
NasrallhM	the Talented	random
NasriahS	Nsrh ツ	random
nasu_nanasi1	なすみんのナニカ	random
nayera_niro	♥الأوزعة	random
NdaGvnd	San♚	random
Ndri_Felix	♠Gratin-2-Sauce►	random
NEC	NEC	company
NeomiCim	Neomi	random
NERO_L	NERO@L	random
NetApp	NetApp	company
nettajane07	Jane♡	random
NettoYu_Arq	Donnis Yumán	random
Networking2014	IFIP Networking 2014	conference
NewLifeLurago	NewLife Cafè	random
NhhBa	彼女求＊ふくなが	random
Nhlanhla_Seke	Seke	random
nhs92ct39a	ちひろ	random
niallhoraniggas	bea	random
niamerdinha	lari	random
nicfarkas	Farkas	random
nickimneybenim	nickimneybenim	random
NienaQistinaa	Qissy∞	random
NienkeErnstsen	Nienke Ernstsen	random
nieve3e	dfsw	random
_nihk	strife	random
niiifaahaniff	thirty1st july ✿	random
nikenhafian	N I K E N	random
NikolaiAas	Nikolai Eide Aas	random
nilgunkeskin	Nilgün Demir	random
nilo_2011	Danilo Carvalho	random
NipsConference	NIPS	conference
nisaazahra	Nisa Amalia Z	random
NisaNisambal	Nisambal	random
Niskhoir	ﻨﺴﺂﺀ	random
nissi_255	にっしー@青春社畜	random
NitaVengas	Anaaaaaaaa	random
njgamo	Noelia Jimenez Gamo	random
nldb12	nldb12	conference
nmnm0126	はう	random
nm_wt	なおみ	random
noeliagalvan_96	Noelia Galván	random
nonew_	*ೄのんたん‧͙·*	random
nontaxxx	のんた	random
northropgrumman	Northrop Grumman	company
novadijey	Nova DwiJayanti	random
NPherwani	Nikunj Pherwani	random
nprkng	Earth Quakes!	random
nr_angel042	ａ♫.°	random
nrldyn	✿ Diyana ✿	random
NrtKbr	Kübra NART	random
nurafnioktavia	Via	random
Nuria_Abelairas	Nuria Gil	random
nurse_hitomi	山崎　瞳	random
__nurzulaikha	ka	random
nvidia	NVIDIA	company
nyam_nyam_cat	にゃむ猫	random
NytNvrEndng	Nitcee	random
ockychicho	OVR	random
OddBrandon	Man On The Moon	random
OFCTwinersSMG	#OpenFollbackTill2k	random
oguzhanhopac	Oğuzhan	random
OhEira	A'nnx	random
OKAERINASign	758	random
okayu210	おかゆ	random
oli_actual_hand	Oli Hand	random
olympia_jobs	Olympia PDL GmbH	random
onourry	saved 4 @mullindick	random
OnTae4ever	Adyla 아딜라	random
OokvWosterhout	OokVanWosterhout.nl	random
oopsla2008	OOPSLA 2008 Conferen	conference
oopsla2009	OOPSLA 2009 Conferen	conference
openstudioNL	Open Studio Staff	random
OptimusPrime_TR	Andres Egi Agustia	random
Oracle	Oracle	company
OriginalHueyBoy	Pablo Escobar	random
OsamaAhmadSalas	الشريف اسامه شلش	random
Othello_Jones	IG: Othello_Jones	random
ourinspiringjdb	♛	random
oustratford	thai	random
owen_rimmer	owen rimmer	random
oxoxo2143	قهوه	random
ozgedursunogluu	ozgedursunoglu	random
ozy_fauziah	Shandy!	random
paatricia26	Patricia Hurtado.	random
pabo_cheoreom	Aline	random
Pacerr24	Zach Pace	random
PacSymBiocomp	Pac Sym Biocomputing	conference
PaigeBarnowski	Paige Barnowski	random
pakdd2010	NeuroTech	conference
PAKDD2012	PAKDD	conference
pakdd2013	PAKDD2013	conference
pakixicodaf	Yinon	random
palmpalmm	palm	random
pam2013hk	PAM2013 | HK	conference
pane_1014	ぱね	random
Parnsport	PAR'N'SPORT	random
partida_julio	● ⓙⓤⓛⓘⓞ ●	random
PauletteAMolina	Paulette Molina	random
PeanutTable	Steven	random
pearlii_mook	• mjrpsw •	random
pembemacaronn	İrem	random
pemmibowie	Bismakanrisna ♥	random
pendergastzyval	valrie pendergast	random
_Pepue	Jo!	random
percom2013	PerCom 2013	conference
PetraRais	Petra Raisová	random
PhillipsAlex10	Alexx	random
Phuangsuay	ตายิ้มของฟานี่♥	random
pine_pine_apple	パイナップル	random
PinkBluntsNBuns	Neya	random
pinkNina__	foreign bitches.	random
pi_pi_piyoyo	さな	random
Pirelli_21	Diego Hurtado Lopez	random
PITPITselvitri	Selvitri	random
piyoco_piyotto	ᐅ ᐅ い ま ひ な	random
pizzafuckers	yiza	random
PLDI	PLDI	conference
pldi2012	PLDI 2012	conference
polarisu111	ぽらりす	random
pollypocket_jh	Jamie Hall	random
ponta0725	ぽん汰	random
POPL2013	POPL13	conference
primrose_kaholu	桜草	random
princefaeast1	HashTag JiwangCrew ®	random
princezoriginal	angelita	random
printsgramLIVE	Printsgram LIVE	random
PrisonerOfYou_	Lauren ;;	random
prissilprihatin	Prissil Prihatina	random
ProfessorWeetoz	David Magnien	random
PropVestment	PropVestment	random
ps_time1	PEACE/ミラー@OORer	random
PT_Jaehwan	Jaegae	random
ptvjoize	Llax	random
punkrocksca	とっさん	random
putriyananf	Putriyana	random
PutryAprilia69	Putri Ayu Aprilia	random
Q1Q3	Luis Enrique Herrera	random
Q8AWS259	abdullah Alsafran	random
Q8FBl	سعد الزريق الخالدي	random
qassemalkhaldi	قاسم الخالدي	random
qimidine	キミ	random
qowssi	keubo	random
Qualcomm	Qualcomm	company
Rabe3Alsulami	CaReZmA #أحمد_كعكي	random
rafizzieothman	DIKTATORIAN	random
Raghad_hamad5	rghad alwehaibi✨	random
RAHAFm5	رهف منصور .	random
railbad	だいじ	random
ramcinnamon	Ramsie Lim	random
ramram_ma	لبيك نصر الله	random
RandyTheon11	RandyTheon	random
RANKdafoo	Black de la Rocha	random
rckhmiy	xawn	random
readytomorrow	readytomorrow	random
RealDutchFlower	Real Dutch Flowers	random
REALREAL_0117	てんち	random
Rebeka22ramos	♥Rebekilla♥	random
rebferrari	Rebecca Ferrari	random
RebLuvKCnBieber	FallInLuvWithUrSelf⚓	random
recomb2010	recomb2010	conference
recomb2011	RECOMB 2011	conference
reeeeeisk_	甘党くん。(旅の途中)	random
Reef__an	ريفان .	random
rehannaaaaaa	rehanna	random
reihan_aqila	schmidt	random
reihanpalmi	reihan palmi	random
RelentlessOzzie	ᴼᴹᴳ ᶥᵗˢTʰᵉBᵒˢˢ	random
ReliefSpain	Relief Spain	random
remonkan753	召喚師レモン缶	random
remued	Kate	random
RenadBahri	Renad	random
respeiito	André Felipe	random
retnoteera	triani retno	random
rev_myk	DreamCha§eR™	random
rexymail	Rexy Fajrin Ismail	random
RezkiNugrahaIky	Rezki Nugraha Sufi	random
Ricke_Noops	Block .	random
Ride_Or_Die_DA	ルイーズ ♊	random
ridhwan_0913	Ridhwan Aziz	random
rigardjvr	Rigard J.v. Rensburg	random
riismalalala	NoName~	random
rikaa33	양 리카 •샌구오•	random
rimoekti	rimoekti laksamana	random
rinafairy	りなぺろ	random
Rinaldisah	Renaldie | indonesia	random
rinarina726	りな∞千葉crewヽ(*･ω･)ﾉ	random
RingDN_R5	ｲﾓﾄ	random
rioooou	莉櫻(りおう)@アニカフェ132122	random
_RIPCourtney	Courtney McCreary	random
RiskaAP3	Riska	random
riswandaw	Riswanda	random
_rizkyahmd	Rizky .P	random
rizkyamandaaaa	Rizky Amanda Sarhir	random
rizkyyohana	yohɑnɑ	random
RNA_Risa	Risaaa:)	random
robsteer	Rob Steer	random
RochiMoretti	ＳＡＬＶＡＴＯＲＥ ♥	random
RocioicoR94	Rocío Jiménez	random
Rocma_	Lionne du Rif	random
rossdiver19	Ross Diver	random
RSantamarinha	Rsantamarinha	random
rufona	ルフォナ	random
RuleML2011	RuleML-2011@BRF	conference
RunaAka	RUNA	random
ryanj_official	Ryan Joseph DLR	random
ryon_pamyu	☻Zoroastrianism☻Ryon	random
Ryu_LED	ころやん	random
ryuuuji92_as	r♡⍢⃝	random
saif_aldhuhouri	اتعبني_غلاك ღ	random
sakisui0714	早紀＠２号(๑･∀･๑)♡	random
sakurai_ero	闇	random
Saldalican	Saldazade.	random
salma123477	اميرة الصمت	random
Sam_362	SammySosa	random
Samaheralh	سماهر الحربي	random
samanthaaleong	*S	random
sami_0021	القعقاع	random
SamirCdidFarah	PRIMER CAMPEÓN CSE	random
SamMike77	Michael Sam	random
samorourkey	sugamommasam	random
sanae_nagatuki	長月早苗(bot)	random
sanathndk	Sanath Indika	random
sanotin41	佐野志郎	random
sanyaan_j	さにゃん(사냥)	random
saori_tm_	木村沙央里	random
SAP	SAP	company
sara_harding27	sara ♡	random
SarahShattered	SarahShattered	random
_sarajade	sarajade_xo	random
SaRoo_Alrashdi	♫'Saяoo♥	random
Sarra_50	ڒعشھٓۂه ﺧﭬﯗوق♡̶̶ٌ♪'̣	random
Sary_Spendoel	BERLIMA {Saryy}	random
satafijidewe	Hadleigh	random
satu_kirinn	さつき	random
saudmnalajmi	سعود مشعل بن حثلين	random
SavannahAlii	Savannah'Kane	random
sbsbv	sarah	random
Sebas_van_Wijk	Sebas van Wijk	random
secretsnews	أسرار الإخبارية	random
seee_dub	Connor Ward	random
SeftyFs	Sefty_safety	random
sehure_deii	セフレでもいい みえ	random
Selene428	Choonghee	random
SelfMade_Liyah	Grind OR Starve .	random
semprepelalua	Dudu	random
sensys_acm	ACM SenSys	conference
sent_OOR	せんち	random
seonqy	qy	random
serge_belov	Sergey Belov	random
Setetes_ilmu	Quenition	random
SfirixtraNews	Sfirixtra News	random
shafikajasni	Bella Swan :)	random
shamefu1life	Shamefu1life	random
sham_tan	hiroshi.takahashi	random
Shanae_Richey	Shanae Richey	random
ShandyZolla	Zolla	random
_Shankha	Shankhadip	random
sharniep5	sharn	random
ShaunaKelley143	Shauna Kelley	random
Shaun_green012	Deshaun Green	random
shay_allen_	s³jª	random
shaylesmith	venus	random
SheezyBurnleezy	shelb	random
sheillavc	CILL'S	random
ShesTOO_much	free Qwadrick	random
shiennamon	Shienna Manrique ♕	random
shitposh	shitposh	random
shoma86050146	ぽてち	random
shoooko0923	しょこさん、	random
SHORDIEEE_	RAlPH lAUREN ツ	random
shu6963	愁	random
shutupsamx	tator hater	random
SiameseCatTwins	SiameseCatTwins4Ever	random
sig_chi	ACM SIGCHI	conference
sigcomm09	sigcomm09	conference
sigcomm12	SIGCOMM 2012	conference
sigcomm2011	SIGCOMM 2011	conference
sigcse2011	SIGCSE 2011	conference
sigcse2012	SIGCSE 2012	conference
SIGCSE_TS	SIGCSE Symposium	conference
sigdoc	SIGDOC	conference
siggraph	ACM SIGGRAPH	conference
SIGIR2013	SIGIR 2013	conference
sigitpradana	sigit	random
sigsoft	ACM SIGSOFT	conference
SIGSPATIAL_GIS	ACM SIGSPATIAL GIS	conference
Sii_yeon	시연	random
siluhandsome	Hiatus	random
SiMONEBABYx	074/053	random
sirogare	颯爽茶(21)	random
SISCHA_GRACE	S I S C A	random
site_kn	して	random
sizu_s	静	random
skr_sotk	佐倉	random
slgahba_shk	まほさん(本物)	random
SltanQlby11	اربع صور	random
smeerkaasbaas	Լυƈ™	random
SmmmMelihDURAN	Melih DURAN	random
smsmosama111	Mayor Osama	random
sng7777	すーさん@ﾌﾟﾘｹﾂｴｸﾞﾚﾁﾌﾞｻ	random
sniffles_to	Очкастая жопа	random
snogbird1110	くま丸	random
snowbsk_531	おがわんわんฅ•ﻌ•ฅ	random
sofia0323	桜華	random
SofiadelaParra1	Sofia de la Parra	random
solpoups	Soledad POUPAT	random
SonaaIzii	Faisal LeKinG ❤	random
sonblnajadat	salsbeel najadat	random
Soniaiml	Sonia Dg	random
soobincess	♤˚˚탐乙r의 CⓗIⓒ 보리˚˚♤	random
SoonToBeAHoran	K A T E	random
sora0se4na	うぐいすver.1.2	random
soshi9_4ever	soshii♥	random
sosp09	ACM SOSP	conference
SOSP13	SOSP 2013	conference
sosp2011	SOSP 2011	conference
soukyumun	蒼穹幻想曲@ボトムズ野郎	random
soulroute	Ssh..	random
SpaceStephX	Stephanie♕	random
Spiderxbass	Spider bass	random
__spkev	Kev	random
splashcon	SPLASH Conference	conference
SRDtv	Stephen Dacres	random
SSTD2011	SSTD	conference
StarLitoSmith	JDM Smith	random
startime15	Hikari	random
stealthycamo	Ash	random
StefanSal_CrV	Stefan Salvatore	random
sthompson5	Scott Thompson	random
stillbornjesus	Viktor Stalzkov	random
stylescuthbert	hannah	random
StyLes_Horan23	ღSennheiser Stylesღ	random
styles_rockme	zayn	random
suddenlybad	M	random
sugar_Milkeyway	佐藤ちーづ@野菜泥棒。	random
_Sugiarto06	Sugiarto	random
suihanki42	4月29日にうまれた炊飯	random
sukaberaksi	Redza Aqasha	random
SuktanAfgan	Suktan Afgan	random
sultana1_af	✖️	random
sultanwadei	مُزْن مُقَدَّس	random
sunainu	すないぬ	random
suninaan	순순이와 순냔	random
Supercomputing	SC14	conference
supereera	Syaheera Tajuddin	random
__superfresh	絢レモン	random
swaagy2	1ans Today :((( ♡	random
SweeneyAustin	AustinJames	random
swifthbu	ts	random
swish_osuBOT	swishBOT	random
Swotist	SWOT-ist	random
Swwannh	Anne-Sophie Danan	random
sxcx_ano0707	チャンスキャッチ☆あやのん	random
Sy103Mh130	みさちゃみ←リア垢	random
syakisan252525	†堕天使しゃきｺﾞﾛｳლ(╹◡╹ლ)†	random
SyifaFith_5	Siipiit•	random
syifaGRECO7	NUR SYIFA	random
sykr97	احماد شاكير	random
symboldrama	Символдрама	random
t0chichi	とちち	random
tai625momo96	ももか	random
taikobu26	小平(立岡)一誠	random
taiyowhale	dai	random
takahashihomare	高橋誉	random
takkkro	たくろー	random
takumi5504	KURAYAN	random
talofagirlarii	Princess Arii	random
tamaki46	大沼 環	random
Tamii_Adrover	26.5♥	random
TaniaMRaggs	Tanzieeee?	random
tanihei818	たにへい	random
taroyan999	タロやん	random
TatsuyaNakane	中根達也	random
Team_Elle	GTs.eLLe	random
TEConnectivity	TE Connectivity	company
telluthetruth	为你而来	random
TELUS	TELUS	company
Temidayo_S_	Temidayo Seriki.	random
TengkuBersiong	KuJan	random
Tenoriocc	Sinclair.T	random
tensainoyume	surfacing	random
tensoka	ﾎﾟﾃﾎﾟﾃﾄ	random
tentsukupoppy	天憑　ポピー	random
tetraceklin	Пока что воин	random
tetsu_saratoga	鴫原 哲也	random
TevaAvrilleaud	Happy.New.Year	random
The1JaySmoov	Jay Smoov	random
thea_n4	ThEa :D	random
theaszn	Thea	random
THEbestjoseMADE	josé	random
theebillymotley	Billy Motley	random
theGuySwiftie13	Fahreza¹³	random
thelegend_zayed	冷血漢 A+	random
Thembz17	Thembela Teketa	random
TheMirez	Turks!	random
themisssara	Sara K	random
ThePeruvianGirl	Jenny Sanchez	random
therauhlinkid	inder	random
TheReal_Neo	#ZaharaMoney	random
therealtyra_	tyra	random
theShmeep	Aletheia	random
TheUMIRaaaa_	ΛmmΛяя MiяzΛ ツ	random
TheyLoveDree	`Undreaa♥	random
ThiagoGuido_	Thiago	random
TiagoKrasota	Krasota	random
Tictactoefix9	Ki Krayon™ #LILKI	random
_tiffano	tkb.	random
tile_elit90	Iyee_elit	random
Tim553Tim	james odonnell	random
timtim0518	ちむ( ◔ิω◔ิ)	random
timtim3104	あべっち＠変態	random
tishalaq8	بوعبدالله مع الشعوب	random
tkm_luv	なみん@べんぜんんんん⌬	random
tk_rikudou	しば	random
tmrjatsjs	マイクラ人	random
tn_galileo	アカウント停止	random
toaruhito	とある人	random
toba_ringo	とばち	random
tobias_7	Tobias Williams	random
tochi_bot	とちぃ	random
Tokonoko309	トコノコα	random
tomaszewicz1	Hannah	random
TomKennerley1	Tom Kennerley	random
Tom_Nicoo	TomNico.	random
tomozo1212	ともぞう	random
tool_phantom2	カビ吉	random
TopiqApihhhh	TaufiqHafiz △̵	random
toshikn_	俊樹	random
toshiSC	トシ	random
tougofeatyuki	がんゆー	random
touyakoikitaimo	みずごろー	random
toxicnashton	♡PLEASE ASHTON♡	random
_TraeMartinez	#Crewshyt Trae	random
TrainingShed	Training Shed	random
TrendTeeClothes	Zebedee ツ	random
trendytommo	tomlinson ☻	random
Triiceee	Triiceeeee'	random
Trill4Life_True	#FollowMajorBit	random
TrippBabyy	TrippBabyy	random
Tri_Pry14	Faith(y) Michelle	random
trish_bonilla	Patricia Bonilla	random
Trisna_Kawai	Tha	random
tristannatama	abang titan^^#	random
troubIemakers	❀ whatever ❀	random
tuki_ame	ポテトS	random
tunderepetto	ゆっこ＝ﾆｺ厨=ママ	random
Tune7_BCP	☆┼ひne™ Carter☆	random
_Tunisian	thugga	random
TuPapiFlores	Flores.	random
tweetiut	chintya pua	random
twicia_law	twicia law	random
twlay1	anafaiza	random
TXInstruments	Texas Instruments	company
tykaamalik	Juwita ♥	random
TylynTheCreator	T¥L¥N	random
TyraNoordin		random
ubicomp	Ubiquitous Computing	conference
ubicomp2009	UbiComp 2009	conference
ubicomp2010	Ubicomp 2010	conference
ubicomp2011	Ubicomp 2011	conference
UbiComp2012	UbiComp 2012	conference
UbiComp2013	UbiComp 2013	conference
ubicompconf	Ubiquitous Computing	conference
UcykBahtiar	ocehan	random
ugaz47	Usman Aboki jr	random
UihaFaiteliha	NANAyo'bidness✌	random
uist2012	UIST 2012	conference
UIST2013	UIST2013	conference
Ukamiya	Ukami	random
UKN48	ゆうけん	random
umhychalsum	umi	random
unifika	Rifka Ramadhona	random
upmahone	brenda	random
urcpress	ЮРЦ МЧС России	random
urnihardiyanti	Dimsky♥	random
Ur_shoug	شوق العميري.	random
usenix	USENIX Association	conference
USENIXSecurity	USENIX Security	conference
ussthiing	Odigie Austin	random
ustadhbrian	TG★D	random
utrehtkeva	Australopitekus	random
UttA7X	Utta~chan	random
uzataka_bot	うざいタカ丸	random
v7yv26cp	かける	random
Valefll93	Val L	random
Valekauimka	Валекаюимка	random
valelagu	Valeria Laguna	random
Valen2117	Valentina Arenas	random
ValentinGomess	~¤C.Ronaldo¤~	random
Valentino_2905	ValentinoB.♥	random
ValleyGurl_Slim	Trending Topic	random
vanessa_christa	vanessa christa	random
vanfdn	Vanee​	random
veensario	Aiveen Mae Sario	random
Vergil_j4_k8t	Vergil	random
VeryCOOL8	Very COOL	random
vi880818	막콘티켓이 안오는 히아chy	random
vibraangeliapur	vibra angelia purba	random
VictConcCrescit	Ichsan Sholichin	random
VICTORiOUS_xox	☞Maya☜	random
viispoladore	Vitória Spoladore	random
viniyanvilia	Yanvilia Dwikurnia	random
vinnagracia	Alvinna Gracia	random
VisagePaleZK	Doux Jésus	random
vit0riasss	vitoria s	random
vitamin_5	てんか(S)	random
Vita_RV2	八神ヴィータ@規制	random
VLDB2012	VLDB 2012	conference
VLDB2013	VLDB2013	conference
vlhcc	VL/HCC	conference
VMware	VMware	company
vx1s	3bood al7osani	random
w3ad_a_4	وٌعد.	random
w4stedw1shes	Courtney	random
WalterTee_YSG	SavageLife	random
wankochan_bot	抱きまくら	random
wannurauni	Auni	random
WaqasAzamkml	Muhammad Waqas	random
watches_f	WATCHES_FASHION	random
Wendelherz	Zombiefaultier ☕	random
werribeeweather	Werribee Weather	random
westonattor	charlotte weston	random
weyheeyziall	☹angie☹	random
whitxnigz	~	random
wiiscaa18	yulia wisca rozi	random
Willl_02	Will_02	random
Windstream	Windstream	company
WiOpt2012	WiOpt 2012	conference
WLittleZombie_	Máscara.	random
wolfy1028	エレノア	random
woo_112	ℱαнαÐ AℒØтїℬ℮	random
wordtoshauna	$hauna Hughes	random
WoWMoM2011	WoWMoM 2011	conference
wtfsel_	Meggie	random
wulllann	ulan	random
WWW2010	WWW2010 - Raleigh	conference
www2011	www2011	conference
www2012Lyon	WWW2012 - Lyon	conference
www2013rio	WWW2013	conference
WWW2014_Korea	WWW2014	conference
xandilson	Alexandre Teitelbaum	random
_xdollie	†	random
Xent_a	Xent@	random
XGims	xav	random
xlatiifax	هاري فكنق ستايلز	random
xLionelMessi10x	. . . . . . .	random
xo3_xo8	鳩太朗	random
x_SHORTYY_	IG: x_SHORTYY_	random
xtomlinsonsocks	₂₈	random
xViitoO	...	random
xxexx2011	ابراهيم المطيري	random
xxx_arinko	ありんこ	random
xynie	Anthony	random
y0urfucksmile	vagina inquieta.	random
Y_0x0_	✿. ｡ゆあちゅ(美少女)	random
y1912uk	フライドチキン	random
y22_ss	ゆきちー	random
yabu_taya	ayaka-yabu♡♡	random
Yahoo	Yahoo	company
YajairaJuarezz	Yajaira.	random
yanagin_pts	琉∠ラヴ・Ｅ・メール・フロム・さいたま	random
yantiFivers_bwi	Say no to love^,^	random
Yeliii_	Nayeli Ramirez	random
yesuria	Jiyongie ♥	random
YG24_perry	ペリーGM	random
ykr_saaakky	ゆかり	random
yogabhaktiw	Yoga Bhakti	random
YohanaAprilia11	Yohana Aprilia	random
yoshiton27	りぽやん＠猫アレルギー	random
Yosserlfc2011	Paul Hughes	random
youadoredavy	Ashley	random
youloveclm	Carolina Martinez	random
youridoei_	youri	random
yousraelmir	You	random
yu86861	ゆかりん	random
yua_mikoto_hmr	柚羽亜@12日アドリブ昼	random
yuekichi20	ユエ	random
Yukaamoon	ゆぅ♬*	random
yukanamm	ゆみか	random
YUKIMAXTVXQ	紫夢☆심유키	random
YuliawArfn	YuliawatiArifin	random
yunikparanitha	yunik	random
yurikov12_danil	Данил юриков	random
yutausa_317xxx	ゆたうさ@たまモン	random
yuto_eri	꒰ｅｒｉ ⋈*｡꒱	random
Yuu_pink_M	ゆー・ ンドウォート	random
yuyuyu_27	☾✰ ⋆ゆきのっち⋆✭ ☾	random
yuzuo555	ゆず	random
z105583	فايز السعيد	random
zahwanmr	-	random
zakieru_ACV	ザキエル@カバン鯖mari	random
zeemketum	ketum	random
zefanyaa_	Key	random
zkhptrmdni	jakiah	random
zulfa_pooh	-	random
zzzzzzzz_69	سادي عنييييف	random
